hujan	rain
panas	hot/sunny
dingin	cold
angin	wind
mendung	cloudy
cerah	clear/bright
gerimis	drizzle
badai	storm
petir	thunder
kilat	lightning
embun	dew
kabut	fog
kering	dry
basah	wet
lembab	humid
sejuk	cool/refreshing
terik	scorching hot
teduh	shady
payung	umbrella
jas hujan	raincoat