cincang	mince/chop finely
aduk	stir/mix
tumis	saut√©/stir-fry
orak-arik	scramble
masukkan	add/put in
tercium	smell/be detected
pindahkan	transfer/move
taburkan	sprinkle
iris	slice
rebus	boil
goreng	fry
kukus	steam
panggang	grill/roast
bakar	grill/barbecue
potong	cut
cuci	wash
bersihkan	clean
kupas	peel
tiriskan	drain
panaskan	heat
dinginkan	cool
tambahkan	add
campurkan	mix
kocok	whisk/beat
uleni	knead
bentuk	shape
hidangkan	serve