senang	happy
sedih	sad
marah	angry
takut	afraid/scared
kecewa	disappointed
bangga	proud
malu	embarrassed/shy
bingung	confused
lelah	tired/exhausted
bosan	bored
rindu	miss someone/longing
sabar	patient
gelisah	restless/anxious
tenang	calm/peaceful
excited	excited
kaget	shocked/surprised
jengkel	annoyed/irritated
lega	relieved
was-was	worried/anxious
haru	touched/moved emotionally