jalan	street/road
trotoar	sidewalk
lampu lalu lintas	traffic light
zebra cross	crosswalk
halte	bus stop
motor	motorcycle
mobil	car
becak	pedicab
ojek	motorcycle taxi
angkot	public minivan
pedagang kaki lima	street vendor
warung	street food stall
tukang bakso	meatball vendor
abang gorengan	fried snacks vendor
pengamen	street musician
tukang ojek	ojek driver
polisi	police officer
satpam	security guard
anak jalanan	street children
gelandangan	homeless person