mengubah	change
berubah	transform
mengganti	replace
menukar	exchange
beralih	switch
menjadi	become
berevolusi	evolve
berkembang	develop
bertransformasi	transform
beradaptasi	adapt
menyesuaikan	adjust
memodifikasi	modify
memperbarui	update
memperbaharui	renew
merevisi	revise
mereformasi	reform
merombak	overhaul
menyebabkan	cause
mengakibatkan	result in
mempengaruhi	influence
berdampak	impact
berefek	have effect
memicu	trigger
menimbulkan	bring about
melahirkan	give rise to
menghasilkan	produce
menciptakan	create
membentuk	form
mewujudkan	realize
merealisasikan	actualize
mengimplementasikan	implement
melaksanakan	execute
menjalankan	carry out
memungkinkan	enable
mengizinkan	allow
membolehkan	permit
membiarkan	let
melarang	forbid
mencegah	prevent
menghalangi	block
menghambat	hinder
menunda	delay
mempercepat	accelerate
memperlambat	slow down
menghentikan	stop
membatalkan	cancel
menangguhkan	postpone
memulai	start
mengawali	initiate
meluncurkan	launch
memicu	initiate
mengelola	manage
mengatur	organize
mengkoordinasi	coordinate
mengontrol	control
mengendalikan	control
mengawasi	supervise
memimpin	lead
mengarahkan	direct
membimbing	guide
menuntun	lead
memandu	guide
mengkomando	command
memerintah	rule
menyuruh	order
menginstruksikan	instruct
mencapai	achieve
meraih	attain
memperoleh	obtain
mendapatkan	get
memenangkan	win
berhasil	succeed
mengatasi	overcome
menyelesaikan	solve
memecahkan	resolve
menangani	handle
menghadapi	face
mengalami	experience
melalui	go through
melewati	pass through
menembus	penetrate
menyeberangi	cross
menempuh	travel
menjelajahi	explore
menyelidiki	investigate
menganalisis	analyze
mengevaluasi	evaluate
menilai	assess
mempertimbangkan	consider
merencanakan	plan
merancang	design
menyusun	arrange
mempersiapkan	prepare
mengorganisir	organize
mengkoordinir	coordinate
menyinkronkan	synchronize
mengintegrasikan	integrate
menggabungkan	combine
menyatukan	unite
memisahkan	separate
membedakan	distinguish
mengklasifikasikan	classify
mengkategorikan	categorize