kepala	head
mata	eyes
hidung	nose
mulut	mouth
telinga	ears
rambut	hair
wajah	face
leher	neck
tangan	hand
jari	finger
kaki	foot/leg
lutut	knee
perut	stomach
punggung	back
dada	chest
bahu	shoulder
siku	elbow
pinggang	waist
paha	thigh
betis	calf
tumit	heel
jempol	thumb
gigi	teeth
lidah	tongue
tubuh	body