nasi	rice
ayam	chicken
ikan	fish
sayur	vegetables
buah	fruit
daging	meat
telur	egg
roti	bread
keju	cheese
mentega	butter
garam	salt
gula	sugar
merica	pepper
bawang	onion
cabe	chili
tomat	tomato
kentang	potato
wortel	carrot
jagung	corn
pisang	banana
apel	apple
jeruk	orange
mangga	mango
kelapa	coconut
durian	durian