baju	shirt/clothes
celana	pants
sepatu	shoes
topi	hat
tas	bag
kaos	t-shirt
kemeja	dress shirt
rok	skirt
dress	dress
jaket	jacket
sandal	sandals
kaos kaki	socks
celana dalam	underwear
bra	bra
ikat pinggang	belt
jam tangan	watch
kacamata	glasses
cincin	ring
kalung	necklace
gelang	bracelet
anting	earrings
pakaian	clothing
besar	big
kecil	small
ukuran	size