air	water
teh	tea
kopi	coffee
jus	juice
susu	milk
bir	beer
anggur	wine
es	ice
minuman	drink/beverage
minum	to drink
haus	thirsty
segar	fresh
panas	hot
dingin	cold
manis	sweet
pahit	bitter
asam	sour
asin	salty
botol	bottle
gelas	glass
cangkir	cup
sedotan	straw
es teh	iced tea
es kopi	iced coffee
air putih	plain water