kampus	campus
tergeletak	lying around
bangku	bench
resleting	zipper
penasaran	curious
catatan	notes
ketinggalan	left behind
titip	entrust
petugas	officer
terburu-buru	in a hurry
eh	hey
nih	here/this
wah	wow
kok	how come
dong	please
nggak	no/not
banget	very
deh	emphasis particle
sambil	while
takut	afraid
cuma	just/only
lain kali	next time