masak	to cook
goreng	to fry
rebus	to boil
panggang	to grill/bake
bakar	to burn/grill
tumis	to saut√©
kukus	to steam
potong	to cut
cincang	to chop
campur	to mix
aduk	to stir
bumbu	spices/seasoning
resep	recipe
bahan	ingredient
minyak	oil
santan	coconut milk
kecap	soy sauce
sambal	chili sauce
kerupuk	crackers
nasi putih	white rice
nasi goreng	fried rice
soto	soup
gado-gado	mixed salad
rendang	rendang
bakso	meatballs